00000000000000000000000000000000000000000000000000000000
00000000000000000000000000000000000000000000000000000000
00000000000000000000000000000000000000000000000000000000
00000000111111111110000000000000000000000000000000000000
00000001122222222211100000000000000000000000000000000000
00000011222222222222111000000000000000000000000000000000
00000112223333333322221110000000000000000000000000000000
00001122244444444333222211100000000000000000000000000000
00011222444444444443332222111000000000000000000000000000
00012224441111114444433322221110000000000000000000000000
00012234411000011144444333222211100000000000000000000000
00012234410000000111444443332222111000000000000000000000
00012234410555550001114444433322221110000000000000000000
00012234410555550000011144444333222211100000000000000000
00012234410555550000000111444443332222111000000000000000
00012234410555550000000001114444433322221110000000000000
00012234410555550000000000011144444333222211100000000000
00012234410555550000000000000111444444332222111000000000
00012234410555550000000000000001114444443322221110000000
00012234410555550000000000000000011144444433222211100000
00012234410555550000000000000000000111444444332222110000
00012234410555550000000000000000000001114444443322211000
00012234410555555555555555555555555000011114444432221000
00012234410555555555555555555555555555000011144443221000
00012234410555555555555555555555555555555000114443221000
00012234410555555555555555555555555555555550011443221000
00012234410555555555555555555555555555555555001443221000
00012234410555555555555555555555555555555555501443221000
00012234410555550000000000000000000000005555501443221000
00012234410555550000000111111111000000005555501443221000
00012234410555550000011144444441100000005555501777771000
00012234410555550001114444444444110000005555501999991000
00012234410000000111444443333444411000005555501669991000
00012234410000011144444432222344441000005555501999661000
00012234410001114444444322222234441100005555501669991000
00012234410111444444433222112223444100005555501999661000
00012234411144444443322221111222344110005555501999991000
00012234444444443332222211001122344410005555501443221000
00012234444444332222221110000122234411005555501443221000
00012234444333222222111000000112234441005555501443221000
00012223333222222211100000000012223441105555501443221000
00011222222222221110000000000011223444100555501443221000
00001122222221111000000000000001222344110555001443221000
00000111111111000000000000000001122344410000001443221000
00000000000000000000000000000000122234411000011443221000
00000000000000000000000000000000112234441111114443221000
00000000000000000000000000000000012223444444444443221000
00000000000000000000000000000000011222344444444433221000
00000000000000000000000000000000001222234444444322211000
00000000000000000000000000000000001122223333333222110000
00000000000000000000000000000000000112222222222221100000
00000000000000000000000000000000000011112222222111000000
00000000000000000000000000000000000000011111111100000000
00000000000000000000000000000000000000000000000000000000
00000000000000000000000000000000000000000000000000000000
00000000000000000000000000000000000000000000000000000000
