000000000000000000000000000000000000000000000000000000000000000000000000000000000000000000000000000000000000000000000000000000000000000000000000000000000000000000000000
000000000000000000000000000000000000000000000000000000000000000000000000000000000000000000000000000000000000000000000000000000000000000000000000000000000000000000000000
000000000000000000000000000000000000000000000000000000000000000000000000000000000000000000000000000000000000000000000000000000000000000000000000000000000000000000000000
000000000000000000000000000000000000000000000000000000000000000000000000000000000000000000000000000000000000000000000000000000000000000000000000000000000000000000000000
000000000000000000000000000000000000000000000000000000000000000000000000000000000000000000000000000000000000000000000000000000000000000000000000000000000000000000000000
000000000000000000000000000000000000000000000000000000000000000000000000000000000000000000000000000000000000000000000000000000000000000000000000000000000000000000000000
000000000000000000000000000000000000000000000000000000000000000000000000000000000000000000000000000000000000000000000000000000000000000000000000000000000000000000000000
000000000000000000000000000000000000000000000000000000000000000000000000000000000000000000000000000000000000000000000000000000000000000000000000000000000000000000000000
000000000000000000000000000000000000000000000000000000000000000000000000000000000000000000000000000000000000000000000000000000000000000000000000000000000000000000000000
000000000000000000000000111111111111111111111111111111111000000000000000000000000000000000000000000000000000000000000000000000000000000000000000000000000000000000000000
000000000000000000000000111111111111111111111111111111111100000000000000000000000000000000000000000000000000000000000000000000000000000000000000000000000000000000000000
000000000000000000000001111111111111111111111111111111111111000000000000000000000000000000000000000000000000000000000000000000000000000000000000000000000000000000000000
000000000000000000000111111222222222222222222222222222111111111000000000000000000000000000000000000000000000000000000000000000000000000000000000000000000000000000000000
000000000000000000000111111222222222222222222222222222211111111100000000000000000000000000000000000000000000000000000000000000000000000000000000000000000000000000000000
000000000000000000001111112222222222222222222222222222221111111111000000000000000000000000000000000000000000000000000000000000000000000000000000000000000000000000000000
000000000000000000111111222222222222222222222222222222222222111111111000000000000000000000000000000000000000000000000000000000000000000000000000000000000000000000000000
000000000000000000111111222222222222222222222222222222222222211111111100000000000000000000000000000000000000000000000000000000000000000000000000000000000000000000000000
000000000000000001111112222222222222222222222222222222222222222111111111000000000000000000000000000000000000000000000000000000000000000000000000000000000000000000000000
000000000000000111111222222222333333333333333333333333222222222222111111111000000000000000000000000000000000000000000000000000000000000000000000000000000000000000000000
000000000000000111111222222223333333333333333333333333222222222222211111111100000000000000000000000000000000000000000000000000000000000000000000000000000000000000000000
000000000000001111112222222333333333333333333333333333222222222222222111111111000000000000000000000000000000000000000000000000000000000000000000000000000000000000000000
000000000000111111222222223333444444444444444444444333333333222222222222111111111000000000000000000000000000000000000000000000000000000000000000000000000000000000000000
000000000000111111222222223344444444444444444444444333333333222222222222211111111100000000000000000000000000000000000000000000000000000000000000000000000000000000000000
000000000001111112222222333344444444444444444444444333333333222222222222222111111110000000000000000000000000000000000000000000000000000000000000000000000000000000000000
000000000111111222222223333444444444444444444444444444444333333333222222222222111111111000000000000000000000000000000000000000000000000000000000000000000000000000000000
000000000111111222222223344444444444444444444444444444444333333333222222222222211111111100000000000000000000000000000000000000000000000000000000000000000000000000000000
000000000111112222222333344444444444444444444444444444444333333333222222222222222111111111000000000000000000000000000000000000000000000000000000000000000000000000000000
000000000111222222223333444444441111111111111444444444444444444333333333222222222222111111111000000000000000000000000000000000000000000000000000000000000000000000000000
000000000111222222223344444444411111111111111144444444444444444333333333222222222222211111111110000000000000000000000000000000000000000000000000000000000000000000000000
000000000111222222233344444444111111111111111111444444444444444333333333222222222222222111111111000000000000000000000000000000000000000000000000000000000000000000000000
000000000111222222333444444441111000000000011111111144444444444444444333333333222222222222111111111000000000000000000000000000000000000000000000000000000000000000000000
000000000111222222333444444411111000000000000111111111444444444444444333333333222222222222211111111100000000000000000000000000000000000000000000000000000000000000000000
000000000111222222333444444111111000000000000111111111444444444444444333333333222222222222222111111111000000000000000000000000000000000000000000000000000000000000000000
000000000111222222333444444111000000000000000000011111111144444444444444444333333333222222222222111111111000000000000000000000000000000000000000000000000000000000000000
000000000111222222333444444111000000000000000000011111111114444444444444444333333333222222222222211111111100000000000000000000000000000000000000000000000000000000000000
000000000111222222333444444111000000000000000000000111111111444444444444444333333333222222222222222111111110000000000000000000000000000000000000000000000000000000000000
000000000111222222333444444111000000000000000000000000001111111444444444444444444333333333222222222222111111111000000000000000000000000000000000000000000000000000000000
000000000111222222333444444111000000000000000000000000000111111114444444444444444333333333222222222222211111111110000000000000000000000000000000000000000000000000000000
000000000111222222333444444111000000000000000000000000000111111111444444444444444333333333222222222222222111111111100000000000000000000000000000000000000000000000000000
000000000111222222333444444111000000000000000000000000000000001111111444444444444444444333333333222222222222111111111000000000000000000000000000000000000000000000000000
000000000111222222333444444111000000000000000000000000000000000111111114444444444444444333333333222222222222211111111110000000000000000000000000000000000000000000000000
000000000111222222333444444111000000000000000000000000000000000111111111444444444444444333333333222222222222222111111111000000000000000000000000000000000000000000000000
000000000111222222333444444111000000000000000000000000000000000000011111111444444444444444444333333333222222222222111111111000000000000000000000000000000000000000000000
000000000111222222333444444111000000000000000000000000000000000000000111111114444444444444444333333333222222222222211111111100000000000000000000000000000000000000000000
000000000111222222333444444111000000000000000000000000000000000000000111111111444444444444444333333333222222222222222111111110000000000000000000000000000000000000000000
000000000111222222333444444111000000000000000000000000000000000000000000111111111444444444444444444333333333222222222222111111111000000000000000000000000000000000000000
000000000111222222333444444111000000000000000000000000000000000000000000001111111114444444444444444333333333222222222222211111111110000000000000000000000000000000000000
000000000111222222333444444111000000000000000000000000000000000000000000000111111111444444444444444333333333222222222222222211111111000000000000000000000000000000000000
000000000111222222333444444111000000000000000000000000000000000000000000000000011111111444444444444444444333333333222222222222111111111000000000000000000000000000000000
000000000111222222333444444111000000000000000000000000000000000000000000000000011111111111444444444444444333333333222222222222211111111100000000000000000000000000000000
000000000111222222333444444111000000000000000000000000000000000000000000000000001111111111444444444444444333333333322222222222221111111110000000000000000000000000000000
000000000111222222333444444111000000000000000000000000000000000000000000000000000000001111111144444444444444444443333333222222222222111111111000000000000000000000000000
000000000111222222333444444111000000000000000000000000000000000000000000000000000000000111111111444444444444444444333333222222222222211111111100000000000000000000000000
000000000111222222333444444111000000000000000000000000000000000000000000000000000000000111111111444444444444444444333333322222222222221111111111000000000000000000000000
000000000111222222333444444111000000000000000000000000000000000000000000000000000000000000001111111144444444444444444443333333222222222222111111111000000000000000000000
000000000111222222333444444111000000000000000000000000000000000000000000000000000000000000000111111111444444444444444444333333222222222222211111111100000000000000000000
000000000111222222333444444111000000000000000000000000000000000000000000000000000000000000000111111111444444444444444444333333322222222222221111111110000000000000000000
000000000111222222333444444111000000000000000000000000000000000000000000000000000000000000000000001111111144444444444444444443333333222222222222111111111000000000000000
000000000111222222333444444111000000000000000000000000000000000000000000000000000000000000000000000111111111444444444444444444333333222222222222211111111100000000000000
000000000111222222333444444111000000000000000000000000000000000000000000000000000000000000000000000111111111444444444444444444333333322222222222221111111110000000000000
000000000111222222333444444111000000000000000000000000000000000000000000000000000000000000000000000000001111111444444444444444444443333333222222222222111111000000000000
000000000111222222333444444111000000000000000000000000000000000000000000000000000000000000000000000000000111111114444444444444444444333333222222222222211111000000000000
000000000111222222333444444111000000000000000000000000000000000000000000000000000000000000000000000000000111111111444444444444444444333333322222222222221111100000000000
000000000111222222333444444111000000000000000000000000000000000000000000000000000000000000000000000000000000001111111444444444444444444443333333222222222111111000000000
000000000111222222333444444111000000000000000000000000000000000000000000000000000000000000000000000000000000000111111114444444444444444444333333222222222211111000000000
000000000111222222333444444111000000000000000000000000000000000000000000000000000000000000000000000000000000000111111111444444444444444444333333322222222221111000000000
000000000111222222333444444111000000000000000000000000000000000000000000000000000000000000000000000000000000000000001111111111444444444444444443333222222222111000000000
000000000111222222333444444111000000000000000000000000000000000000000000000000000000000000000000000000000000000000000111111111114444444444444444333222222222111000000000
000000000111222222333444444111000000000000000000000000000000000000000000000000000000000000000000000000000000000000000111111111111444444444444444333322222222111000000000
000000000111222222333444444111000000000000000000000000000000000000000000000000000000000000000000000000000000000000000000000001111111144444444444443333222222111000000000
000000000111222222333444444111000000000000000000000000000000000000000000000000000000000000000000000000000000000000000000000000111111114444444444444333222222111000000000
000000000111222222333444444111000000000000000000000000000000000000000000000000000000000000000000000000000000000000000000000000111111111444444444444333222222111000000000
000000000111222222333444444111000000000000000000000000000000000000000000000000000000000000000000000000000000000000000000000000000001111114444444444333222222111000000000
000000000111222222333444444111000000000000000000000000000000000000000000000000000000000000000000000000000000000000000000000000000000111111444444444333222222111000000000
000000000111222222333444444111000000000000000000000000000000000000000000000000000000000000000000000000000000000000000000000000000000111111444444444333222222111000000000
000000000111222222333444444111000000000000000000000000000000000000000000000000000000000000000000000000000000000000000000000000000000000111114444444333222222111000000000
000000000111222222333444444111000000000000000000000000000000000000000000000000000000000000000000000000000000000000000000000000000000000111111444444333222222111000000000
000000000111222222333444444111000000000000000000000000000000000000000000000000000000000000000000000000000000000000000000000000000000000111111444444333222222111000000000
000000000111222222333444444111000000000000000000000000000000000000000000000000000000000000000000000000000000000000000000000000000000000000111444444333222222111000000000
000000000111222222333444444111000000000000000000000000000000000000000000000000000000000000000000000000000000000000000000000000000000000000111444444333222222111000000000
000000000111222222333444444111000000000000000000000000000000000000000000000000000000000000000000000000000000000000000000000000000000000000111444444333222222111000000000
000000000111222222333444444111000000000000000000000000000000000000000000000000000000000000000000000000000000000000000000000000000000000000111444444333222222111000000000
000000000111222222333444444111000000000000000000000000000000000000000000000000000000000000000000000000000000000000000000000000000000000000111444444333222222111000000000
000000000111222222333444444111000000000000000000000000000000000000000000000000000000000000000000000000000000000000000000000000000000000000111444444333222222111000000000
000000000111222222333444444111000000000000000000000000000000000000000000000000000000000000000000000000000000000000000000000000000000000000111444444333222222111000000000
000000000111222222333444444111000000000000000000000000000000000000000000000000000000000000000000000000000000000000000000000000000000000000111444444333222222111000000000
000000000111222222333444444111000000000000000000000000000000000000000000000000000000000000000000000000000000000000000000000000000000000000111444444333222222111000000000
000000000111222222333444444111000000000000000000000000000000000000000111111111111111111111111111000000000000000000000000000000000000000000111444444333222222111000000000
000000000111222222333444444111000000000000000000000000000000000000001111111111111111111111111111000000000000000000000000000000000000000000111444444333222222111000000000
000000000111222222333444444111000000000000000000000000000000000000111111111111111111111111111111100000000000000000000000000000000000000000111444444333222222111000000000
000000000111222222333444444111000000000000000000000000000000000111111111444444444444444444444111111000000000000000000000000000000000000000111666666666666666111000000000
000000000111222222333444444111000000000000000000000000000000001111111111444444444444444444444111111000000000000000000000000000000000000000111666666666666666111000000000
000000000111222222333444444111000000000000000000000000000000111111111144444444444444444444444111111100000000000000000000000000000000000000111666666666666666111000000000
000000000111222222333444444111000000000000000000000000000111111111444444444444444444444444444444111111000000000000000000000000000000000000111333333333333333111000000000
000000000111222222333444444111000000000000000000000000001111111144444444444444444444444444444444111111000000000000000000000000000000000000111333333333333333111000000000
000000000111222222333444444111000000000000000000000000111111114444444444444444444444444444444444111111100000000000000000000000000000000000111333333333333333111000000000
000000000111222222333444444111000000000000000000000111111111444444444444444333333333333444444444444111111000000000000000000000000000000000111888888333333333111000000000
000000000111222222333444444111000000000000000000001111111114444444444444444333333333333444444444444111111000000000000000000000000000000000111888888333333333111000000000
000000000111222222333444444111000000000000000000111111111144444444444444443333333333333344444444444111111000000000000000000000000000000000111888888333333333111000000000
000000000111222222333444444111000000000000000111111111444444444444444444333322222222223333444444444444111000000000000000000000000000000000111333333333888888111000000000
000000000111222222333444444111000000000000111111111114444444444444444444333222222222222333444444444444111000000000000000000000000000000000111333333333888888111000000000
000000000111222222333444444111000000000001111111114444444444444444444443333222222222222333344444444444111100000000000000000000000000000000111333333333888888111000000000
000000000111222222333444444111000000000111111111444444444444444444444333322222222222222223333444444444411111000000000000000000000000000000111888888333333333111000000000
000000000111222222333444444111000000000111111114444444444444444444444333222222222222222222333444444444411111000000000000000000000000000000111888888333333333111000000000
000000000111222222333444444111000000111111111144444444444444444444443333222222222222222222333344444444441111000000000000000000000000000000111888888333333333111000000000
000000000111222222333444444111000111111111444444444444444444444333333322222222221112222222223333444444444111000000000000000000000000000000111333333333888888111000000000
000000000111222222333444444111000111111111444444444444444444444333333222222222221112222222222333444444444111000000000000000000000000000000111333333333888888111000000000
000000000111222222333444444111001111111114444444444444444444443333333222222222111111222222222333344444444411100000000000000000000000000000111333333333888888111000000000
000000000111222222333444444111111111444444444444444444444333333322222222222221111111112222222223333444444411111000000000000000000000000000111333333333333333111000000000
000000000111222222333444444411111111444444444444444444444333333222222222222221111111112222222222333444444411111000000000000000000000000000111333333333333333111000000000
000000000111222222333444444441111114444444444444444444443333333222222222222111111111111222222222333444444441111000000000000000000000000000111333333333333333111000000000
000000000111222222333444444444444444444444444444333333333322222222222222221111000000111112222222333444444444111000000000000000000000000000111444444333222222111000000000
000000000111222222333444444444444444444444444444333333333222222222222222221111000000111112222222333444444444111100000000000000000000000000111444444333222222111000000000
000000000111222222333444444444444444444444444443333333333222222222222222111111000000111111222222333344444444111110000000000000000000000000111444444333222222111000000000
000000000111222222333444444444444444444444333333322222222222222222221111111000000000000111222222223333444444411111000000000000000000000000111444444333222222111000000000
000000000111222222333444444444444444444444333333222222222222222222221111111000000000000111222222222333444444411111000000000000000000000000111444444333222222111000000000
000000000111222222333444444444444444444443333333222222222222222222111111111000000000000111222222222333444444441111000000000000000000000000111444444333222222111000000000
000000000111222222333444444444444333333333322222222222222222221111111000000000000000000111112222222333444444444111100000000000000000000000111444444333222222111000000000
000000000111222222333444444444444333333333222222222222222222221111111000000000000000000111112222222333444444444111100000000000000000000000111444444333222222111000000000
000000000111222222333344444444443333333333222222222222222222111111111000000000000000000111111222222333344444444111100000000000000000000000111444444333222222111000000000
000000000111222222223333333333333322222222222222222222221111111000000000000000000000000000111222222223333444444111111000000000000000000000111444444333222222111000000000
000000000111222222222333333333333222222222222222222222221111111000000000000000000000000000111222222222333444444411111000000000000000000000111444444333222222111000000000
000000000111222222222333333333333222222222222222222222111111111000000000000000000000000000111222222222333444444411111000000000000000000000111444444333222222111000000000
000000000111112222222222222222222222222222222222221111111000000000000000000000000000000000111112222222333444444444111000000000000000000000111444444333222222111000000000
000000000111112222222222222222222222222222222222221111111000000000000000000000000000000000111112222222333444444444111000000000000000000000111444444333222222111000000000
000000000111111222222222222222222222222222222222111111111000000000000000000000000000000000111111222222333344444444111100000000000000000000111444444333222222111000000000
000000000000111112222222222222222222222221111111111000000000000000000000000000000000000000000111222222223333444444111111000000000000000000111444444333222222111000000000
000000000000111112222222222222222222222221111111111000000000000000000000000000000000000000000111222222222333444444411111000000000000000000111444444333222222111000000000
000000000000111111222222222222222222222111111111111000000000000000000000000000000000000000000111222222222333444444441111000000000000000000111444444333222222111000000000
000000000000000111111111111111111111111111000000000000000000000000000000000000000000000000000111112222222333444444444111000000000000000000111444444333222222111000000000
000000000000000111111111111111111111111111000000000000000000000000000000000000000000000000000111112222222333444444444111000000000000000000111444444333222222111000000000
000000000000000111111111111111111111111111000000000000000000000000000000000000000000000000000111111222222333344444444411000000000000000000111444444333222222111000000000
000000000000000000000000000000000000000000000000000000000000000000000000000000000000000000000000111222222223333444444411111000000000000111111444444333222222111000000000
000000000000000000000000000000000000000000000000000000000000000000000000000000000000000000000000111222222222333444444441111000000000000111114444444333222222111000000000
000000000000000000000000000000000000000000000000000000000000000000000000000000000000000000000000111222222222333444444444111100000000001111144444444333222222111000000000
000000000000000000000000000000000000000000000000000000000000000000000000000000000000000000000000111112222222333444444444411111111111111111444444444333222222111000000000
000000000000000000000000000000000000000000000000000000000000000000000000000000000000000000000000111112222222333444444444441111111111111114444444444333222222111000000000
000000000000000000000000000000000000000000000000000000000000000000000000000000000000000000000000111111222222333344444444444111111111111144444444444333222222111000000000
000000000000000000000000000000000000000000000000000000000000000000000000000000000000000000000000000111222222223333444444444444444444444444444444444333222222111000000000
000000000000000000000000000000000000000000000000000000000000000000000000000000000000000000000000000111222222222333444444444444444444444444444444444333222222111000000000
000000000000000000000000000000000000000000000000000000000000000000000000000000000000000000000000000111222222222333344444444444444444444444444444444333222222111000000000
000000000000000000000000000000000000000000000000000000000000000000000000000000000000000000000000000111112222222223333444444444444444444444444444333333222222111000000000
000000000000000000000000000000000000000000000000000000000000000000000000000000000000000000000000000111112222222222333444444444444444444444444444333333222222111000000000
000000000000000000000000000000000000000000000000000000000000000000000000000000000000000000000000000111111222222222333344444444444444444444444443333332222222111000000000
000000000000000000000000000000000000000000000000000000000000000000000000000000000000000000000000000000111222222222223333444444444444444444444333322222222222111000000000
000000000000000000000000000000000000000000000000000000000000000000000000000000000000000000000000000000111222222222222333444444444444444444444333222222222222111000000000
000000000000000000000000000000000000000000000000000000000000000000000000000000000000000000000000000000111222222222222333344444444444444444443333222222222221111000000000
000000000000000000000000000000000000000000000000000000000000000000000000000000000000000000000000000000111112222222222223333333333333333333333322222222222111110000000000
000000000000000000000000000000000000000000000000000000000000000000000000000000000000000000000000000000111112222222222222333333333333333333333222222222222111110000000000
000000000000000000000000000000000000000000000000000000000000000000000000000000000000000000000000000000111111222222222222333333333333333333333222222222221111000000000000
000000000000000000000000000000000000000000000000000000000000000000000000000000000000000000000000000000000111112222222222222222222222222222222222222222111110000000000000
000000000000000000000000000000000000000000000000000000000000000000000000000000000000000000000000000000000111112222222222222222222222222222222222222222111110000000000000
000000000000000000000000000000000000000000000000000000000000000000000000000000000000000000000000000000000111111222222222222222222222222222222222222221111000000000000000
000000000000000000000000000000000000000000000000000000000000000000000000000000000000000000000000000000000000111111111222222222222222222222222222222111110000000000000000
000000000000000000000000000000000000000000000000000000000000000000000000000000000000000000000000000000000000111111111222222222222222222222222222222111110000000000000000
000000000000000000000000000000000000000000000000000000000000000000000000000000000000000000000000000000000000111111111111222222222222222222222222111111000000000000000000
000000000000000000000000000000000000000000000000000000000000000000000000000000000000000000000000000000000000000000001111111111111111111111111111111000000000000000000000
000000000000000000000000000000000000000000000000000000000000000000000000000000000000000000000000000000000000000000001111111111111111111111111111111000000000000000000000
000000000000000000000000000000000000000000000000000000000000000000000000000000000000000000000000000000000000000000000111111111111111111111111111000000000000000000000000
000000000000000000000000000000000000000000000000000000000000000000000000000000000000000000000000000000000000000000000000000000000000000000000000000000000000000000000000
000000000000000000000000000000000000000000000000000000000000000000000000000000000000000000000000000000000000000000000000000000000000000000000000000000000000000000000000
000000000000000000000000000000000000000000000000000000000000000000000000000000000000000000000000000000000000000000000000000000000000000000000000000000000000000000000000
000000000000000000000000000000000000000000000000000000000000000000000000000000000000000000000000000000000000000000000000000000000000000000000000000000000000000000000000
000000000000000000000000000000000000000000000000000000000000000000000000000000000000000000000000000000000000000000000000000000000000000000000000000000000000000000000000
000000000000000000000000000000000000000000000000000000000000000000000000000000000000000000000000000000000000000000000000000000000000000000000000000000000000000000000000
000000000000000000000000000000000000000000000000000000000000000000000000000000000000000000000000000000000000000000000000000000000000000000000000000000000000000000000000
000000000000000000000000000000000000000000000000000000000000000000000000000000000000000000000000000000000000000000000000000000000000000000000000000000000000000000000000
000000000000000000000000000000000000000000000000000000000000000000000000000000000000000000000000000000000000000000000000000000000000000000000000000000000000000000000000
